71 71 71 71 71 71 71 71 71 71 71 71 71 71 71 71 817 817 817 817 817 817 817 817 817 817 817 817 817 817 817 817 817 817 817 817 817 817 817 817 817 817 817 817 817 817 817 817 817 817 817 817 817 817 817 817 817 817 817 
71 71 71 71 71 71 71 71 71 71 71 71 71 71 71 71 817 817 817 817 817 817 817 817 817 817 817 817 817 817 817 817 817 817 817 817 817 817 817 817 817 817 817 817 817 817 817 817 817 817 817 817 817 817 817 817 817 817 817 
71 71 71 71 71 71 71 71 71 71 71 71 71 71 71 71 817 817 817 817 817 817 817 817 817 817 817 817 817 817 817 817 817 817 817 817 817 817 817 817 817 817 817 817 817 817 817 817 817 817 817 817 817 817 817 817 817 817 817 
71 71 71 71 71 71 71 71 71 71 71 71 71 71 71 71 817 817 817 392 817 817 817 817 817 817 817 817 817 817 817 817 817 817 817 817 817 817 817 817 817 817 817 817 817 817 817 817 817 817 817 817 817 817 817 817 817 817 817 
71 71 71 71 71 71 71 71 71 71 71 71 71 71 71 71 817 817 817 817 817 817 817 817 817 817 817 817 817 817 817 817 817 817 817 817 817 817 817 817 817 817 817 817 817 817 817 817 817 817 817 817 817 817 817 817 817 817 817 
143 143 143 143 143 143 143 143 143 143 143 143 143 143 143 146 807 817 817 817 817 817 817 817 817 817 817 593 817 817 817 817 817 817 817 817 817 817 817 817 817 817 817 817 817 817 593 817 817 817 817 817 817 392 817 817 817 817 817 
303 303 610 303 303 303 303 303 303 303 303 303 303 303 303 5 807 817 817 8 817 817 817 817 817 817 817 817 817 817 817 817 817 817 817 817 817 817 817 817 817 817 817 817 817 817 817 817 817 817 817 817 817 817 817 817 817 817 817 
303 303 303 303 303 303 303 303 303 303 303 303 303 303 303 5 807 817 817 817 8 817 817 817 817 817 817 593 817 817 817 817 817 593 817 817 817 817 817 817 817 817 817 817 817 817 817 817 817 817 817 817 817 817 817 817 817 817 817 
303 303 578 303 303 303 303 303 303 303 303 578 303 303 303 5 807 817 8 8 817 817 817 817 817 817 817 817 817 817 817 817 817 817 522 817 817 817 817 817 10 10 817 817 817 817 817 817 817 817 817 817 817 817 817 817 817 817 817 
303 303 303 303 303 303 303 303 303 303 303 303 303 303 303 5 807 8 8 8 8 817 817 817 817 817 817 817 817 817 817 817 817 817 817 522 817 817 817 817 9 9 817 817 817 817 817 817 817 560 559 559 560 560 817 817 817 817 817 
303 303 303 303 303 303 303 303 303 303 303 303 303 303 303 5 807 7 8 9 10 11 12 13 14 15 16 17 18 19 20 21 22 23 24 25 26 27 28 29 30 31 817 817 817 817 817 817 817 560 559 594 594 817 817 817 817 817 817 
32 144 32 32 33 482 482 482 482 482 32 33 34 608 36 37 807 39 40 41 42 43 44 45 46 47 48 49 50 51 52 53 54 55 56 57 58 59 60 61 62 63 817 392 817 817 817 559 560 10 594 625 560 625 625 817 817 817 817 
303 176 303 303 65 303 303 303 303 303 64 65 608 608 68 69 807 71 72 73 74 75 76 77 78 79 80 81 82 83 84 85 86 87 88 89 90 91 92 93 94 95 817 817 817 817 560 626 625 559 560 594 594 817 817 817 817 817 817 
303 303 303 303 65 303 303 303 303 303 96 97 98 99 100 101 102 103 104 105 106 107 108 109 110 111 112 113 114 115 116 117 118 119 120 121 122 123 124 125 126 127 817 817 817 817 817 626 817 817 817 817 817 560 817 817 817 817 817 
604 605 303 303 65 303 303 303 303 303 128 129 130 131 132 133 134 135 136 137 138 139 140 141 142 143 144 145 146 492 148 149 150 151 152 153 154 155 156 157 158 159 817 817 817 559 817 817 817 817 817 817 559 817 817 817 817 817 817 
636 637 303 303 65 303 303 303 303 303 160 161 162 163 164 165 807 167 168 169 170 171 172 173 367 367 176 367 178 492 180 181 182 183 184 185 186 187 188 189 190 191 817 817 817 817 817 817 817 817 13 13 13 13 13 13 13 13 13 
668 303 303 303 65 303 303 303 303 303 192 193 608 195 196 197 807 199 200 201 202 203 204 205 367 207 208 209 210 492 212 213 214 215 216 217 218 219 220 221 222 223 145 145 145 145 145 145 145 145 146 13 13 13 13 13 13 13 13 
303 303 303 303 65 303 303 303 303 303 224 225 608 227 228 229 230 231 232 233 234 235 236 367 367 239 240 241 242 492 244 245 246 247 248 249 250 270 270 253 254 270 270 270 270 270 270 270 270 270 178 13 13 13 13 13 13 13 13 
303 303 303 303 65 303 303 303 303 303 256 257 608 259 260 261 262 263 264 265 266 267 268 269 270 271 272 273 367 278 276 277 278 279 280 281 270 270 284 285 286 287 304 304 304 304 304 304 304 304 178 13 13 13 13 13 13 13 13 
288 288 288 288 289 288 288 288 288 288 288 289 290 608 292 293 807 295 296 297 298 299 300 301 367 303 304 305 306 307 308 309 310 311 312 313 314 315 316 317 318 319 304 271 304 304 304 304 304 304 178 13 13 13 13 13 13 13 13 
807 593 807 807 807 807 807 807 807 807 807 807 807 323 324 807 807 327 328 329 330 331 332 333 367 335 336 337 338 807 340 341 342 343 344 345 346 270 348 349 350 351 304 304 304 578 304 304 271 304 242 13 13 13 13 13 13 13 13 
559 71 71 559 71 71 392 71 71 552 352 353 354 355 356 357 358 359 360 361 362 363 364 365 367 367 368 369 370 807 372 373 374 375 376 377 378 379 380 381 270 383 304 304 304 304 304 304 304 304 270 277 277 279 617 247 46 622 280 
71 593 71 71 71 71 71 71 520 552 384 385 386 387 388 389 390 391 392 393 394 395 396 397 398 399 400 401 402 807 404 405 406 407 408 409 410 270 270 270 270 415 304 271 304 304 304 304 304 304 270 308 309 309 308 312 308 308 308 
71 71 559 71 71 71 71 71 71 520 416 417 418 419 420 421 422 423 424 425 426 427 428 807 807 431 432 807 807 807 436 437 438 439 440 441 442 270 444 445 446 447 304 304 304 304 304 304 304 304 338 13 13 13 13 13 13 13 13 
71 71 71 71 71 71 71 71 71 71 448 449 450 451 452 453 454 455 456 457 458 459 460 461 462 463 464 465 466 467 468 469 470 471 472 473 474 475 476 477 270 479 304 304 304 304 304 304 304 304 178 13 13 13 13 13 13 13 13 
770 770 770 770 770 770 770 770 770 770 480 481 482 483 484 485 807 487 488 489 490 491 492 493 494 495 496 497 498 499 500 501 270 270 504 505 506 507 270 270 270 511 304 304 271 578 304 304 304 304 178 13 13 13 13 626 13 13 13 
608 608 608 728 729 730 731 608 608 608 608 608 608 608 608 517 807 519 520 521 522 523 524 525 526 527 528 529 530 531 532 533 270 535 536 537 538 539 540 541 270 543 304 304 271 304 304 304 304 304 242 13 626 13 13 593 13 626 13 
609 609 695 537 537 537 537 541 609 609 544 545 546 547 548 549 807 551 552 553 554 555 556 557 558 559 560 561 562 563 564 565 270 270 270 270 270 270 270 270 270 575 304 304 304 304 304 304 271 304 270 13 13 13 13 13 13 593 13 
609 609 608 608 608 608 608 608 609 609 576 577 578 608 580 581 807 583 584 585 586 587 588 589 590 591 592 593 594 595 596 597 598 599 600 601 602 603 604 605 606 607 304 304 304 304 304 304 304 304 270 13 13 13 626 13 13 13 13 
609 609 609 609 609 609 609 609 609 609 608 609 608 608 612 612 277 615 616 617 618 619 620 621 622 623 624 625 626 627 628 629 630 631 632 633 634 635 636 637 638 639 304 304 304 271 304 304 304 304 338 492 492 13 13 13 13 13 13 
609 609 609 602 603 604 605 609 609 609 640 641 642 643 644 645 646 647 648 649 650 651 652 653 654 655 656 657 658 659 660 661 270 663 664 665 666 667 668 669 670 671 271 304 304 578 304 304 304 304 178 492 492 13 13 13 13 13 13 
609 609 609 634 635 636 637 609 609 609 672 673 674 608 676 677 807 679 680 681 682 683 684 685 686 687 688 689 690 691 692 693 270 695 696 697 698 699 700 701 270 703 304 304 304 304 271 304 304 304 178 492 13 13 13 13 392 13 13 
609 609 609 609 667 668 609 609 609 609 704 705 608 608 708 709 807 711 712 713 714 715 716 717 718 719 720 721 722 723 724 725 270 727 728 729 730 731 270 270 270 735 304 304 304 304 304 304 304 304 178 492 13 13 626 13 13 13 13 
609 609 609 609 609 609 609 609 609 609 736 737 738 739 740 741 807 743 744 745 746 747 748 749 750 751 752 753 754 755 756 757 758 759 760 761 762 763 764 765 766 767 767 767 767 767 767 767 767 767 402 492 13 13 13 13 13 13 13 
770 770 770 770 770 770 770 770 770 770 768 769 770 771 772 773 807 775 776 777 778 779 780 781 782 783 784 785 786 787 788 492 492 492 492 492 492 492 492 492 492 492 492 492 492 492 492 492 492 492 492 492 13 13 13 13 13 13 13 
808 808 808 808 808 808 807 807 807 807 807 807 807 807 807 807 807 807 808 809 810 811 812 813 814 815 816 817 818 819 820 821 822 823 824 825 826 827 828 829 830 831 825 825 825 825 825 825 825 825 492 13 13 13 13 13 13 13 13 
817 817 817 817 817 817 817 817 817 817 817 817 817 817 817 817 817 817 817 817 559 559 559 817 817 817 817 817 817 817 817 626 817 817 817 817 817 817 817 392 817 817 817 817 817 817 817 817 817 817 817 817 817 817 817 817 817 817 817 
817 817 817 817 817 817 817 817 559 817 817 817 817 817 817 817 817 559 817 817 559 593 593 817 817 817 817 817 817 817 817 817 817 817 817 817 817 817 817 817 817 817 817 817 817 817 817 817 817 817 817 817 817 817 817 817 626 817 817 
817 817 817 817 817 817 817 817 817 559 817 626 817 817 817 817 559 817 817 817 817 593 593 817 559 817 817 626 559 817 817 817 817 559 559 817 559 817 817 817 817 817 817 817 817 817 559 817 817 817 626 817 817 817 817 817 817 817 817 
817 817 817 817 817 817 559 817 817 817 817 817 817 817 817 817 817 817 817 559 817 559 817 817 817 817 817 817 817 817 817 817 817 817 817 817 817 817 817 817 817 817 817 817 626 559 559 817 817 817 817 817 817 817 817 817 817 817 817 
817 817 817 817 817 584 817 817 817 817 817 817 817 817 817 817 817 817 817 817 817 817 817 817 817 817 584 817 817 817 817 817 817 817 817 817 817 817 817 817 817 817 817 817 817 817 817 817 817 817 817 817 817 817 817 584 817 817 817 
655 655 655 655 655 655 655 655 655 655 655 655 655 655 655 655 655 655 655 655 655 655 655 655 655 655 655 655 655 655 655 655 655 655 655 655 655 655 655 655 655 655 655 655 655 655 655 655 655 655 655 655 655 655 655 655 655 655 655 
648 648 648 648 647 647 647 647 647 647 647 647 647 647 647 647 647 647 647 647 647 647 647 647 647 647 647 647 647 647 647 647 647 647 647 647 647 647 647 647 647 647 647 647 647 647 647 647 647 647 647 647 647 647 647 647 647 655 655 
648 648 648 648 647 647 647 647 647 647 647 647 647 647 647 647 647 647 647 647 647 647 647 647 647 647 647 647 647 647 647 647 647 647 647 647 647 647 647 647 647 647 647 647 647 647 647 647 647 647 647 647 647 647 647 647 647 655 655 
655 655 655 655 655 655 655 655 655 655 655 655 655 655 655 655 655 655 655 655 655 655 655 655 655 655 655 655 655 655 655 655 655 655 655 655 655 655 655 655 655 655 655 655 655 655 655 655 655 655 655 655 655 655 655 655 655 655 655 
809 809 809 809 809 809 809 809 809 584 809 809 809 809 626 809 809 809 809 809 809 809 809 809 809 809 809 809 809 809 809 809 809 809 809 809 809 809 809 809 809 809 809 809 809 809 584 809 809 809 809 809 809 809 809 809 809 809 809 
809 809 809 809 809 809 809 809 809 809 809 809 809 809 809 809 809 809 809 809 809 809 809 809 809 809 809 809 809 809 809 809 809 809 809 809 809 809 809 809 809 809 809 809 809 809 809 809 809 809 809 809 809 809 809 809 809 809 809 
809 809 809 809 809 809 809 809 809 809 809 809 809 809 809 809 809 809 809 809 809 809 809 809 809 809 809 809 809 809 809 809 809 809 809 809 809 809 626 809 809 809 809 809 809 809 809 809 809 809 809 809 809 809 809 809 809 809 809
